GEO_ID,Population 18 to 24 years,Population 18 to 24 years-Less than high school graduate,Population 18 to 24 years-High school graduate (includes equivalency),Population 18 to 24 years-Some college or associate's degree,Population 18 to 24 years-Bachelor's degree or higher,Population 25 years and over,Population 25 years and over-Less than 9th grade,"Population 25 years and over-9th to 12th grade, no diploma",Population 25 years and over-High school graduate (includes equivalency),"Population 25 years and over-Some college, no degree",Population 25 years and over-Associate's degree,Population 25 years and over-Bachelor's degree,Population 25 years and over-Graduate or professional degree,Population 25 years and over-High school graduate or higher,Population 25 years and over-Bachelor's degree or higher
1400000US53033000101,278,71,17,90,100,2718,187,80,492,362,250,949,398,2451,1347
1400000US53033000102,402,50,125,104,123,3578,75,172,717,379,315,981,939,3331,1920
1400000US53033000201,301,0,234,53,14,3616,15,232,412,512,199,1242,1004,3369,2246
1400000US53033000202,228,0,54,102,72,3194,69,187,443,406,179,1174,736,2938,1910
1400000US53033000300,477,25,60,318,74,1933,41,113,189,342,223,639,386,1779,1025
1400000US53033000402,258,65,21,109,63,4364,125,100,639,1324,228,1075,873,4139,1948
1400000US53033000403,195,0,0,89,106,2543,9,110,339,666,319,625,475,2424,1100
1400000US53033000404,287,0,107,180,0,3118,220,63,496,1260,346,487,246,2835,733
1400000US53033000500,49,24,0,15,10,2385,12,9,187,268,94,1069,746,2364,1815
1400000US53033000601,415,11,192,152,60,3524,142,41,551,859,201,1139,591,3341,1730
1400000US53033000602,312,59,8,67,178,2837,121,141,441,459,326,771,578,2575,1349
1400000US53033000700,778,0,117,302,359,3993,162,185,520,841,267,950,1068,3646,2018
1400000US53033000800,257,39,16,64,138,2096,7,54,160,307,164,694,710,2035,1404
1400000US53033000900,101,0,52,32,17,1784,14,7,123,196,56,655,733,1763,1388
1400000US53033001000,210,21,64,80,45,1407,16,43,106,215,82,442,503,1348,945
1400000US53033001100,150,10,38,55,47,2089,69,18,230,215,94,885,578,2002,1463
1400000US53033001201,396,17,143,133,103,3054,78,255,502,711,349,783,376,2721,1159
1400000US53033001202,491,10,52,256,173,2090,0,106,170,384,164,587,679,1984,1266
1400000US53033001300,514,101,103,107,203,3931,217,16,531,706,366,1385,710,3698,2095
1400000US53033001400,83,12,48,23,0,4352,38,4,646,527,327,1599,1211,4310,2810
1400000US53033001500,142,0,100,24,18,2306,0,42,183,469,185,907,520,2264,1427
1400000US53033001600,330,25,80,72,153,3404,0,6,212,355,170,1330,1331,3398,2661
1400000US53033001701,287,0,84,48,155,3579,92,134,436,583,135,1691,508,3353,2199
1400000US53033001702,136,0,15,43,78,4282,109,91,506,663,332,1638,943,4082,2581
1400000US53033001800,527,16,42,264,205,3851,58,48,244,514,312,1655,1020,3745,2675
1400000US53033001900,400,56,9,119,216,3966,49,80,281,484,289,1744,1039,3837,2783
1400000US53033002000,293,34,132,86,41,3127,0,0,175,674,406,1034,838,3127,1872
1400000US53033002100,423,34,114,48,227,3275,19,48,293,570,92,1418,835,3208,2253
1400000US53033002200,432,20,115,203,94,4386,0,11,198,450,353,1460,1914,4375,3374
1400000US53033002400,103,8,19,55,21,2557,33,12,106,337,141,736,1192,2512,1928
1400000US53033002500,127,0,0,74,53,2745,13,43,166,256,134,1063,1070,2689,2133
1400000US53033002600,439,12,108,125,194,4016,0,0,126,552,136,1811,1391,4016,3202
1400000US53033002700,602,0,115,171,316,4347,39,44,178,439,214,1799,1634,4264,3433
1400000US53033002800,119,0,18,80,21,4125,12,38,343,580,238,1745,1169,4075,2914
1400000US53033002900,205,56,50,55,44,3597,0,38,312,655,92,1461,1039,3559,2500
1400000US53033003000,283,0,64,124,95,4910,45,73,491,612,140,2354,1195,4792,3549
1400000US53033003100,221,32,45,32,112,4921,25,0,321,849,205,1998,1523,4896,3521
1400000US53033003201,203,48,48,72,35,3852,12,57,343,749,248,1237,1206,3783,2443
1400000US53033003202,181,45,74,15,47,3656,0,0,209,685,256,1227,1279,3656,2506
1400000US53033003301,229,0,74,126,29,3685,0,30,146,383,176,1909,1041,3655,2950
1400000US53033003302,285,2,149,42,92,3092,44,35,387,451,118,1300,757,3013,2057
1400000US53033003400,255,0,32,70,153,2754,39,20,139,215,279,1102,960,2695,2062
1400000US53033003500,236,17,68,68,83,3439,19,0,268,305,79,1438,1330,3420,2768
1400000US53033003601,370,0,48,19,303,3133,85,0,7,264,151,1839,787,3048,2626
1400000US53033003602,333,51,33,89,160,3356,0,0,202,413,159,1456,1126,3356,2582
1400000US53033003800,285,24,42,66,153,1795,6,1,46,166,86,846,644,1788,1490
1400000US53033003900,270,21,33,67,149,2037,48,15,64,90,101,736,983,1974,1719
1400000US53033004000,192,13,77,61,41,2281,40,108,163,220,97,718,935,2133,1653
1400000US53033004101,165,13,65,44,43,3040,0,0,30,13,122,1033,1842,3040,2875
1400000US53033004102,240,33,20,47,140,2699,10,17,84,218,34,1013,1323,2672,2336
1400000US53033004201,153,13,35,27,78,2554,58,48,117,290,131,875,1035,2448,1910
1400000US53033004202,340,0,22,102,216,3476,0,15,134,282,141,1169,1735,3461,2904
1400000US53033004301,812,62,118,423,209,2255,0,15,74,313,141,817,895,2240,1712
1400000US53033004302,2509,27,500,1700,282,1512,10,0,246,250,74,490,442,1502,932
1400000US53033004401,1629,159,418,624,428,2286,39,58,110,253,0,776,1050,2189,1826
1400000US53033004402,1457,37,206,778,436,1794,39,0,56,297,85,896,421,1755,1317
1400000US53033004500,688,0,60,505,123,2271,15,24,67,179,178,988,820,2232,1808
1400000US53033004600,224,34,39,47,104,2690,29,15,129,267,139,1350,761,2646,2111
1400000US53033004701,356,4,0,18,334,2639,0,76,152,382,118,1040,871,2563,1911
1400000US53033004702,149,0,30,0,119,2801,34,12,89,158,94,1441,973,2755,2414
1400000US53033004703,235,0,0,54,181,3117,0,0,255,192,27,1903,740,3117,2643
1400000US53033004800,284,10,26,155,93,4381,0,33,287,392,248,1851,1570,4348,3421
1400000US53033004901,743,0,61,113,569,3324,22,91,343,358,168,1395,947,3211,2342
1400000US53033004902,500,0,30,118,352,2809,0,0,111,297,121,1364,916,2809,2280
1400000US53033005000,460,56,52,138,214,3459,36,103,178,385,279,1306,1172,3320,2478
1400000US53033005100,236,54,28,59,95,2705,18,62,172,238,156,1108,951,2625,2059
1400000US53033005201,689,20,66,374,229,2757,0,16,111,555,482,806,787,2741,1593
1400000US53033005202,1929,0,209,916,804,1280,17,0,111,89,14,576,473,1263,1049
1400000US53033005303,3308,0,844,2356,108,142,0,27,4,38,5,29,39,115,68
1400000US53033005304,2891,22,941,1855,73,184,0,9,15,39,11,72,38,175,110
1400000US53033005305,1254,43,259,766,186,967,13,14,30,266,14,396,234,940,630
1400000US53033005306,2063,14,307,1349,393,1659,75,70,102,244,183,473,512,1514,985
1400000US53033005307,3028,40,670,2130,188,185,0,10,27,30,17,81,20,175,101
1400000US53033005401,253,0,55,55,143,2829,16,10,109,208,47,1494,945,2803,2439
1400000US53033005402,454,0,9,218,227,2601,38,0,104,319,94,958,1088,2563,2046
1400000US53033005600,79,0,42,0,37,5287,62,0,313,619,415,1832,2046,5225,3878
1400000US53033005700,289,0,56,178,55,5022,46,26,396,588,250,2138,1578,4950,3716
1400000US53033005801,569,0,37,233,299,5247,16,7,348,542,444,2413,1477,5224,3890
1400000US53033005803,102,0,15,13,74,2627,4,69,108,456,114,1075,801,2554,1876
1400000US53033005804,383,0,200,114,69,2104,58,0,82,213,232,961,558,2046,1519
1400000US53033005901,1909,49,112,1573,175,2023,0,0,250,162,62,923,626,2023,1549
1400000US53033005902,172,51,13,62,46,3060,14,15,41,433,181,1355,1021,3031,2376
1400000US53033006000,678,10,28,450,190,4969,27,61,484,857,168,1972,1400,4881,3372
1400000US53033006100,253,15,34,75,129,4921,16,16,208,551,126,1803,2201,4889,4004
1400000US53033006200,302,38,41,56,167,3410,13,0,115,221,107,1181,1773,3397,2954
1400000US53033006300,216,32,0,137,47,4314,2,17,52,404,164,2156,1519,4295,3675
1400000US53033006400,291,32,117,67,75,2710,15,13,104,216,57,1262,1043,2682,2305
1400000US53033006500,302,9,13,84,196,4125,0,50,153,395,177,1923,1427,4075,3350
1400000US53033006600,348,0,15,111,222,3847,8,0,72,380,60,2104,1223,3839,3327
1400000US53033006701,219,0,0,0,219,2755,0,0,0,19,335,1026,1375,2755,2401
1400000US53033006702,144,0,17,48,79,2690,0,0,145,277,36,1393,839,2690,2232
1400000US53033006703,291,17,0,111,163,3052,0,14,242,590,386,963,857,3038,1820
1400000US53033006800,131,24,21,33,53,2480,0,0,37,164,27,1134,1118,2480,2252
1400000US53033006900,329,82,0,52,195,3756,15,10,145,485,290,1625,1186,3731,2811
1400000US53033007001,25,0,0,0,25,3625,9,23,203,583,324,1606,877,3593,2483
1400000US53033007002,386,27,116,79,164,2996,0,156,332,443,166,1356,543,2840,1899
1400000US53033007101,254,3,0,33,218,2504,10,33,90,420,223,1046,682,2461,1728
1400000US53033007102,136,0,0,33,103,2339,29,20,100,302,93,889,906,2290,1795
1400000US53033007201,443,0,22,38,383,4796,0,106,189,264,309,2092,1836,4690,3928
1400000US53033007202,309,0,65,96,148,2749,86,0,183,151,0,1169,1160,2663,2329
1400000US53033007203,451,0,130,105,216,2744,150,0,117,295,99,1056,1027,2594,2083
1400000US53033007301,689,0,0,137,552,1916,12,35,87,308,254,726,494,1869,1220
1400000US53033007302,305,0,76,57,172,3854,42,77,271,337,243,1091,1793,3735,2884
1400000US53033007303,217,0,0,0,217,2055,7,0,125,170,78,799,876,2048,1675
1400000US53033007403,209,0,5,57,147,2862,0,0,157,275,135,1537,758,2862,2295
1400000US53033007404,217,0,55,86,76,2528,18,34,18,266,184,1162,846,2476,2008
1400000US53033007405,429,0,19,196,214,2297,246,25,116,496,214,885,315,2026,1200
1400000US53033007406,433,14,28,14,377,2025,12,40,182,431,64,580,716,1973,1296
1400000US53033007501,431,0,1,306,124,3694,101,5,569,479,140,1058,1342,3588,2400
1400000US53033007502,322,34,0,82,206,2247,0,0,43,293,130,1224,557,2247,1781
1400000US53033007503,327,0,0,0,327,1895,0,0,194,232,183,771,515,1895,1286
1400000US53033007600,657,199,18,131,309,3545,50,21,291,260,81,1278,1564,3474,2842
1400000US53033007700,232,21,72,0,139,4603,15,8,331,484,310,1840,1615,4580,3455
1400000US53033007800,774,92,79,138,465,4214,33,66,229,309,140,1668,1769,4115,3437
1400000US53033007901,333,18,0,37,278,2592,53,104,91,444,109,1062,729,2435,1791
1400000US53033007902,434,0,23,74,337,2856,66,13,109,507,266,1160,735,2777,1895
1400000US53033008002,403,0,74,201,128,3461,24,75,337,595,179,1303,948,3362,2251
1400000US53033008003,206,0,21,58,127,3929,71,37,378,330,22,1424,1667,3821,3091
1400000US53033008004,173,0,0,0,173,3113,0,0,94,200,115,1413,1291,3113,2704
1400000US53033008101,101,0,22,63,16,2552,182,18,184,476,155,853,684,2352,1537
1400000US53033008102,199,0,66,40,93,2140,87,150,250,467,71,685,430,1903,1115
1400000US53033008200,697,0,0,134,563,3696,1,5,209,689,99,1486,1207,3690,2693
1400000US53033008300,454,0,33,43,378,2763,200,113,241,399,107,850,853,2450,1703
1400000US53033008401,224,0,2,97,125,2532,88,89,212,405,187,817,734,2355,1551
1400000US53033008402,364,0,33,131,200,2441,0,61,223,342,41,1222,552,2380,1774
1400000US53033008500,554,108,100,148,198,3744,177,335,680,852,134,982,584,3232,1566
1400000US53033008600,2975,44,306,2153,472,3436,13,107,189,539,434,1263,891,3316,2154
1400000US53033008700,694,0,119,231,344,3305,74,92,359,655,279,1078,768,3139,1846
1400000US53033008800,149,0,40,9,100,3551,212,27,281,445,110,1281,1195,3312,2476
1400000US53033008900,492,59,83,267,83,4845,187,214,569,516,256,1707,1396,4444,3103
1400000US53033009000,313,31,56,99,127,2993,135,104,405,637,153,1103,456,2754,1559
1400000US53033009100,143,0,0,16,127,2510,711,232,368,226,130,656,187,1567,843
1400000US53033009200,118,0,0,67,51,2557,209,242,415,526,180,744,241,2106,985
1400000US53033009300,232,27,32,104,69,2693,23,90,319,531,217,908,605,2580,1513
1400000US53033009400,241,0,50,18,173,5996,559,29,592,715,420,2314,1367,5408,3681
1400000US53033009500,416,75,99,160,82,5118,105,111,335,547,555,1831,1634,4902,3465
1400000US53033009600,109,14,52,43,0,4883,130,22,262,708,276,1709,1776,4731,3485
1400000US53033009701,311,42,17,128,124,5105,0,26,518,770,286,1851,1654,5079,3505
1400000US53033009702,423,45,27,110,241,3839,20,20,308,668,279,1522,1022,3799,2544
1400000US53033009801,229,35,21,142,31,2760,44,22,392,529,135,1144,494,2694,1638
1400000US53033009802,16,0,16,0,0,3297,18,38,336,613,142,1355,795,3241,2150
1400000US53033009900,307,125,37,70,75,5064,58,114,624,945,463,1892,968,4892,2860
1400000US53033010001,596,49,134,368,45,2912,420,175,433,495,202,685,502,2317,1187
1400000US53033010002,372,37,70,106,159,3928,318,134,418,661,267,1456,674,3476,2130
1400000US53033010101,608,198,252,120,38,2870,281,141,363,615,115,781,574,2448,1355
1400000US53033010102,202,15,88,94,5,3347,134,102,562,315,91,1306,837,3111,2143
1400000US53033010200,216,63,49,79,25,3808,80,57,303,498,270,1482,1118,3671,2600
1400000US53033010301,218,0,76,14,128,3158,111,146,820,392,265,562,862,2901,1424
1400000US53033010302,63,0,0,0,63,2490,49,27,209,123,76,1090,916,2414,2006
1400000US53033010401,384,111,33,119,121,3326,375,285,725,480,188,791,482,2666,1273
1400000US53033010402,275,6,76,123,70,3648,419,161,966,622,365,766,349,3068,1115
1400000US53033010501,406,0,26,198,182,3091,86,117,340,540,163,1241,604,2888,1845
1400000US53033010502,154,0,0,108,46,4637,0,24,306,957,353,1512,1485,4613,2997
1400000US53033010601,228,35,65,111,17,3575,115,88,223,495,516,1321,817,3372,2138
1400000US53033010602,91,0,73,0,18,3530,38,36,323,618,281,1535,699,3456,2234
1400000US53033010701,108,0,7,54,47,3213,107,125,735,524,278,950,494,2981,1444
1400000US53033010702,401,49,85,192,75,2917,228,140,420,538,202,911,478,2549,1389
1400000US53033010800,378,125,29,206,18,3604,55,44,589,616,297,1247,756,3505,2003
1400000US53033010900,20,0,0,14,6,935,3,52,165,207,75,349,84,880,433
1400000US53033011001,516,133,47,280,56,3614,838,295,808,658,116,636,263,2481,899
1400000US53033011002,394,51,107,161,75,2751,525,172,779,441,249,475,110,2054,585
1400000US53033011101,442,31,116,186,109,3948,333,337,905,718,402,830,423,3278,1253
1400000US53033011102,172,16,24,18,114,4206,125,4,807,575,311,1563,821,4077,2384
1400000US53033011200,232,83,47,83,19,2654,334,271,750,379,207,580,133,2049,713
1400000US53033011300,290,42,92,84,72,4997,314,152,708,1316,736,1014,757,4531,1771
1400000US53033011401,606,59,157,287,103,3640,127,198,643,850,523,802,497,3315,1299
1400000US53033011402,341,43,119,160,19,3181,275,240,643,536,332,758,397,2666,1155
1400000US53033011500,196,14,62,53,67,3509,5,85,396,704,377,1202,740,3419,1942
1400000US53033011601,109,17,13,32,47,2613,62,32,281,248,67,1214,709,2519,1923
1400000US53033011602,188,44,34,52,58,2764,0,54,236,279,188,1461,546,2710,2007
1400000US53033011700,621,125,85,252,159,4262,587,534,1116,737,315,620,353,3141,973
1400000US53033011801,432,138,177,96,21,2406,308,108,381,388,245,708,268,1990,976
1400000US53033011802,170,29,68,73,0,3354,287,82,632,791,422,802,338,2985,1140
1400000US53033011901,195,45,0,127,23,3115,137,299,739,638,310,567,425,2679,992
1400000US53033011902,82,0,25,47,10,2858,140,123,427,858,391,693,226,2595,919
1400000US53033012000,175,40,70,57,8,2641,18,88,379,568,203,844,541,2535,1385
1400000US53033012100,52,14,10,17,11,2138,1,51,188,376,132,978,412,2086,1390
1400000US53033020100,166,9,47,38,72,2504,16,48,191,421,147,999,682,2440,1681
1400000US53033020200,213,39,19,127,28,4260,52,212,638,925,349,1211,873,3996,2084
1400000US53033020301,293,64,0,162,67,2748,121,83,375,535,206,975,453,2544,1428
1400000US53033020302,221,13,53,140,15,2881,45,224,533,534,362,723,460,2612,1183
1400000US53033020401,243,9,65,55,114,2849,79,85,493,676,385,744,387,2685,1131
1400000US53033020402,371,87,174,73,37,3820,48,81,483,552,565,1101,990,3691,2091
1400000US53033020500,460,89,71,248,52,5273,313,132,787,918,550,1700,873,4828,2573
1400000US53033020600,251,23,72,102,54,2658,93,71,349,675,254,970,246,2494,1216
1400000US53033020700,335,26,52,193,64,2959,93,166,529,495,296,971,409,2700,1380
1400000US53033020800,302,19,65,138,80,3188,32,141,404,454,268,1093,796,3015,1889
1400000US53033020900,120,16,41,41,22,2603,25,76,194,447,110,1010,741,2502,1751
1400000US53033021000,258,37,129,64,28,4606,277,171,695,986,359,1322,796,4158,2118
1400000US53033021100,321,19,74,148,80,3347,6,138,485,496,263,1366,593,3203,1959
1400000US53033021300,591,0,36,362,193,3021,94,119,417,472,327,815,777,2808,1592
1400000US53033021400,193,57,57,39,40,2791,9,28,241,565,162,997,789,2754,1786
1400000US53033021500,104,37,44,8,15,3447,14,19,351,461,288,1369,945,3414,2314
1400000US53033021600,212,22,102,76,12,3947,33,98,525,689,337,1302,963,3816,2265
1400000US53033021701,319,79,77,88,75,2827,6,35,394,401,152,1176,663,2786,1839
1400000US53033021702,319,57,99,41,122,3793,183,43,596,762,284,1260,665,3567,1925
1400000US53033021802,629,197,134,274,24,3938,189,158,560,719,204,1497,611,3591,2108
1400000US53033021803,248,0,53,169,26,4158,56,76,651,905,478,1292,700,4026,1992
1400000US53033021804,769,73,229,395,72,3374,198,125,284,568,248,1130,821,3051,1951
1400000US53033021903,394,60,61,163,110,4537,102,120,692,737,453,1559,874,4315,2433
1400000US53033021904,320,55,78,154,33,3716,154,109,526,655,319,1210,743,3453,1953
1400000US53033021905,313,0,48,204,61,4284,9,95,805,611,536,1597,631,4180,2228
1400000US53033021906,213,16,99,98,0,3307,53,86,292,566,369,1125,816,3168,1941
1400000US53033022001,261,40,66,68,87,4221,32,194,543,726,353,1416,957,3995,2373
1400000US53033022003,406,31,70,136,169,4057,94,142,609,576,289,1787,560,3821,2347
1400000US53033022005,347,16,74,189,68,3451,70,21,287,703,355,1476,539,3360,2015
1400000US53033022006,230,0,4,155,71,3485,55,42,377,589,180,1458,784,3388,2242
1400000US53033022101,250,13,115,97,25,3700,75,79,399,671,306,1332,838,3546,2170
1400000US53033022102,299,111,89,75,24,4464,44,158,442,666,541,1324,1289,4262,2613
1400000US53033022201,355,40,133,141,41,3451,32,185,570,803,379,891,591,3234,1482
1400000US53033022203,403,9,29,194,171,3612,14,19,351,541,144,1397,1146,3579,2543
1400000US53033022204,124,16,0,77,31,2424,13,80,398,409,204,786,534,2331,1320
1400000US53033022205,361,0,23,16,322,3032,106,2,302,584,187,1202,649,2924,1851
1400000US53033022300,122,0,65,39,18,1926,15,0,166,300,91,870,484,1911,1354
1400000US53033022401,130,0,13,91,26,2545,0,39,119,266,118,1321,682,2506,2003
1400000US53033022402,385,42,81,149,113,4057,128,44,305,336,120,2090,1034,3885,3124
1400000US53033022501,287,23,157,82,25,3086,31,91,231,271,222,1019,1221,2964,2240
1400000US53033022502,171,0,59,73,39,3177,18,0,355,563,185,1097,959,3159,2056
1400000US53033022603,424,0,172,161,91,4449,108,57,446,830,206,1770,1032,4284,2802
1400000US53033022604,374,59,112,159,44,3596,25,41,212,604,256,1486,972,3530,2458
1400000US53033022605,694,1,94,381,218,5163,120,180,822,1018,401,1730,892,4863,2622
1400000US53033022606,258,0,78,115,65,4541,69,0,695,732,267,1552,1226,4472,2778
1400000US53033022701,204,12,38,44,110,2675,6,40,83,356,241,1179,770,2629,1949
1400000US53033022702,806,27,153,549,77,2507,27,21,150,272,87,1086,864,2459,1950
1400000US53033022703,210,6,60,108,36,2082,18,58,123,205,304,879,495,2006,1374
1400000US53033022802,454,23,89,281,61,4034,32,44,269,269,409,1741,1270,3958,3011
1400000US53033022803,431,45,211,50,125,4711,102,48,360,369,208,1660,1964,4561,3624
1400000US53033022804,335,0,98,116,121,4113,154,67,346,216,170,1606,1554,3892,3160
1400000US53033022805,135,0,23,100,12,2819,14,0,109,256,64,976,1400,2805,2376
1400000US53033022901,140,13,37,20,70,2477,32,29,274,316,107,909,810,2416,1719
1400000US53033022902,243,61,58,88,36,4609,26,32,351,482,303,1761,1654,4551,3415
1400000US53033023000,471,12,109,141,209,4664,37,79,359,770,204,1703,1512,4548,3215
1400000US53033023100,243,28,48,102,65,3081,35,24,243,414,166,1314,885,3022,2199
1400000US53033023201,294,11,11,118,154,4380,85,91,268,333,261,1495,1847,4204,3342
1400000US53033023202,417,54,128,98,137,3422,270,111,499,570,264,1163,545,3041,1708
1400000US53033023300,326,69,74,155,28,5344,310,303,579,758,442,1557,1395,4731,2952
1400000US53033023401,264,6,43,169,46,2981,175,82,277,332,301,914,900,2724,1814
1400000US53033023403,245,2,74,112,57,2805,38,42,135,467,163,1111,849,2725,1960
1400000US53033023404,282,114,112,56,0,2396,27,11,231,305,111,1178,533,2358,1711
1400000US53033023500,214,24,26,98,66,2963,25,14,200,436,408,1019,861,2924,1880
1400000US53033023601,285,30,124,68,63,3420,29,129,425,378,234,1146,1079,3262,2225
1400000US53033023603,564,114,181,169,100,4855,349,170,507,415,218,1741,1455,4336,3196
1400000US53033023604,318,65,114,108,31,4561,178,258,824,562,246,1452,1041,4125,2493
1400000US53033023701,171,7,17,103,44,3552,48,70,213,441,160,1188,1432,3434,2620
1400000US53033023702,28,0,7,0,21,266,0,0,4,10,0,140,112,266,252
1400000US53033023801,255,15,63,62,115,2328,205,33,125,269,120,725,851,2090,1576
1400000US53033023805,213,0,11,34,168,2551,0,12,261,180,171,785,1142,2539,1927
1400000US53033023806,268,30,0,0,238,2731,11,26,150,329,16,1086,1113,2694,2199
1400000US53033023807,367,0,39,90,238,4867,26,24,197,538,105,1886,2091,4817,3977
1400000US53033023808,194,0,0,27,167,2090,0,17,124,322,77,949,601,2073,1550
1400000US53033023901,225,41,53,56,75,3158,4,52,312,418,197,1126,1049,3102,2175
1400000US53033023902,117,49,52,16,0,1934,17,15,46,172,94,909,681,1902,1590
1400000US53033024001,236,37,76,86,37,2847,3,3,322,290,259,1098,872,2841,1970
1400000US53033024002,225,15,97,35,78,2676,22,38,100,354,131,1204,827,2616,2031
1400000US53033024100,194,24,63,57,50,3575,56,43,122,395,233,1318,1408,3476,2726
1400000US53033024200,197,52,97,30,18,2281,16,44,81,215,81,960,884,2221,1844
1400000US53033024301,335,16,47,58,214,3729,33,40,497,502,447,1251,959,3656,2210
1400000US53033024302,165,10,75,22,58,3128,9,54,174,273,249,1446,923,3065,2369
1400000US53033024400,302,134,78,42,48,2196,0,26,163,326,98,859,724,2170,1583
1400000US53033024500,196,6,57,58,75,3420,61,12,136,341,125,1256,1489,3347,2745
1400000US53033024601,160,55,0,55,50,3375,1,10,100,281,72,1316,1595,3364,2911
1400000US53033024602,184,65,29,60,30,2549,39,7,138,134,36,912,1283,2503,2195
1400000US53033024701,289,35,52,138,64,2342,109,40,450,353,159,705,526,2193,1231
1400000US53033024703,225,0,33,103,89,2838,13,23,197,432,228,1064,881,2802,1945
1400000US53033024704,102,20,17,65,0,3005,92,27,209,650,240,933,854,2886,1787
1400000US53033024800,363,60,124,148,31,4065,60,171,784,798,262,1172,818,3834,1990
1400000US53033024901,331,19,168,91,53,3406,46,10,174,277,193,1284,1422,3350,2706
1400000US53033024902,324,60,112,130,22,2845,13,24,277,338,153,1158,882,2808,2040
1400000US53033024904,247,54,43,114,36,2090,0,51,130,209,137,799,764,2039,1563
1400000US53033024905,181,67,47,40,27,2662,66,15,107,147,105,1038,1184,2581,2222
1400000US53033025001,229,39,17,140,33,4376,90,61,178,412,238,1765,1632,4225,3397
1400000US53033025005,487,24,83,215,165,3716,8,66,215,439,222,1502,1264,3642,2766
1400000US53033025006,423,108,93,164,58,4443,12,29,426,536,264,1575,1601,4402,3176
1400000US53033025007,350,36,101,119,94,3444,0,73,225,372,294,1225,1255,3371,2480
1400000US53033025008,120,0,61,35,24,1591,0,81,94,110,95,637,574,1510,1211
1400000US53033025101,848,103,220,346,179,4089,235,133,998,680,351,967,725,3721,1692
1400000US53033025103,427,0,206,174,47,2897,69,66,451,661,401,910,339,2762,1249
1400000US53033025104,266,7,134,112,13,2752,100,107,625,473,158,861,428,2545,1289
1400000US53033025201,301,70,73,128,30,2870,227,78,686,385,337,861,296,2565,1157
1400000US53033025202,417,90,250,57,20,3476,368,247,970,452,280,686,473,2861,1159
1400000US53033025302,193,44,55,88,6,3833,108,197,1276,852,311,711,378,3528,1089
1400000US53033025303,189,0,61,52,76,1827,79,34,204,466,225,465,354,1714,819
1400000US53033025304,316,18,102,127,69,3309,126,33,528,701,339,1152,430,3150,1582
1400000US53033025401,315,27,147,131,10,2704,367,49,685,423,170,531,479,2288,1010
1400000US53033025402,393,27,229,84,53,2721,292,72,891,614,250,450,152,2357,602
1400000US53033025500,495,43,189,220,43,3588,231,193,1027,711,293,761,372,3164,1133
1400000US53033025601,362,66,121,154,21,3560,239,374,1101,440,319,766,321,2947,1087
1400000US53033025602,363,98,100,131,34,4473,190,185,553,825,850,1371,499,4098,1870
1400000US53033025702,256,54,34,112,56,2266,53,119,519,512,213,649,201,2094,850
1400000US53033025703,353,13,170,113,57,2563,89,54,580,685,217,693,245,2420,938
1400000US53033025704,270,81,107,9,73,1905,56,131,685,291,126,438,178,1718,616
1400000US53033025803,463,33,162,159,109,3066,107,208,671,1133,268,519,160,2751,679
1400000US53033025804,312,45,41,195,31,2463,100,73,663,675,368,446,138,2290,584
1400000US53033025805,337,19,57,238,23,3925,224,139,955,769,613,880,345,3562,1225
1400000US53033025806,303,7,60,186,50,3514,137,87,870,794,299,838,489,3290,1327
1400000US53033026001,187,0,44,122,21,4183,193,247,588,1080,468,1129,478,3743,1607
1400000US53033026003,556,281,38,141,96,2166,204,96,431,513,352,465,105,1866,570
1400000US53033026004,155,18,35,32,70,3287,57,185,829,465,827,502,422,3045,924
1400000US53033026101,344,60,66,141,77,3477,411,225,813,753,272,776,227,2841,1003
1400000US53033026102,230,19,56,155,0,2867,234,135,582,793,358,660,105,2498,765
1400000US53033026200,516,32,230,138,116,4328,148,453,1067,898,493,784,485,3727,1269
1400000US53033026300,133,17,57,13,46,1027,91,103,329,224,84,106,90,833,196
1400000US53033026400,193,25,76,78,14,4406,356,406,1477,906,341,648,272,3644,920
1400000US53033026500,309,101,67,107,34,3058,529,393,778,427,213,572,146,2136,718
1400000US53033026600,258,9,134,106,9,1675,27,96,328,417,175,386,246,1552,632
1400000US53033026700,422,170,144,100,8,3679,292,362,453,730,366,1026,450,3025,1476
1400000US53033026801,391,93,120,163,15,4185,558,245,1438,869,299,545,231,3382,776
1400000US53033026802,499,18,205,202,74,4198,522,349,855,953,532,715,272,3327,987
1400000US53033027000,277,10,57,169,41,2209,227,268,608,381,146,377,202,1714,579
1400000US53033027100,227,67,60,100,0,2865,393,201,715,704,251,461,140,2271,601
1400000US53033027200,212,63,58,36,55,1786,298,173,470,273,174,256,142,1315,398
1400000US53033027300,575,95,178,247,55,3760,930,224,730,661,278,628,309,2606,937
1400000US53033027400,549,117,156,247,29,3486,309,278,1019,687,360,663,170,2899,833
1400000US53033027500,274,41,70,124,39,3510,318,303,809,994,437,444,205,2889,649
1400000US53033027600,469,169,180,106,14,3092,452,272,660,419,298,661,330,2368,991
1400000US53033027701,368,0,290,65,13,4166,29,136,741,894,244,1038,1084,4001,2122
1400000US53033027702,150,1,64,53,32,3956,2,41,528,878,254,1373,880,3913,2253
1400000US53033027800,71,0,28,43,0,2802,31,18,342,726,280,923,482,2753,1405
1400000US53033027901,249,88,69,52,40,3481,115,195,734,763,376,914,384,3171,1298
1400000US53033027902,361,0,210,59,92,2667,140,276,592,568,314,573,204,2251,777
1400000US53033028000,507,54,381,66,6,2941,367,207,912,716,223,443,73,2367,516
1400000US53033028100,322,43,51,210,18,1884,169,123,712,510,76,214,80,1592,294
1400000US53033028200,379,102,153,106,18,3562,258,179,1246,792,323,592,172,3125,764
1400000US53033028300,239,49,45,132,13,3998,262,86,791,898,570,1096,295,3650,1391
1400000US53033028402,472,51,142,266,13,3708,420,159,974,874,392,759,130,3129,889
1400000US53033028403,347,29,131,170,17,3507,69,340,887,1172,298,578,163,3098,741
1400000US53033028500,278,121,74,68,15,3033,281,106,917,756,239,475,259,2646,734
1400000US53033028600,275,62,59,96,58,4959,10,132,807,945,518,1899,648,4817,2547
1400000US53033028700,460,0,183,154,123,3868,173,179,722,821,542,1155,276,3516,1431
1400000US53033028801,274,68,116,82,8,2620,219,179,818,740,176,369,119,2222,488
1400000US53033028802,356,60,88,126,82,4672,543,533,1413,929,549,487,218,3596,705
1400000US53033028901,118,0,45,73,0,2692,87,37,737,575,236,668,352,2568,1020
1400000US53033028902,817,188,364,222,43,4260,497,88,1260,1211,422,550,232,3675,782
1400000US53033029001,303,108,58,107,30,3449,153,194,669,1110,326,641,356,3102,997
1400000US53033029003,299,68,166,65,0,4204,406,514,1073,638,544,663,366,3284,1029
1400000US53033029004,359,89,163,93,14,2302,414,423,758,364,153,160,30,1465,190
1400000US53033029101,263,33,86,135,9,2220,116,233,588,325,172,482,304,1871,786
1400000US53033029102,359,41,161,114,43,3393,427,175,1180,699,262,547,103,2791,650
1400000US53033029203,521,189,131,149,52,2988,97,358,966,836,283,272,176,2533,448
1400000US53033029205,473,86,129,258,0,3352,135,152,978,596,241,951,299,3065,1250
1400000US53033029206,422,120,129,142,31,3106,263,259,996,899,270,295,124,2584,419
1400000US53033029207,236,12,29,85,110,1801,98,57,238,528,230,464,186,1646,650
1400000US53033029208,829,141,245,281,162,2363,160,161,766,548,193,388,147,2042,535
1400000US53033029304,303,57,109,116,21,3586,98,109,905,713,333,899,529,3379,1428
1400000US53033029305,383,50,153,147,33,3147,188,51,758,614,328,724,484,2908,1208
1400000US53033029306,376,26,117,211,22,2391,225,108,402,692,281,532,151,2058,683
1400000US53033029307,237,34,120,76,7,2980,100,108,723,529,264,851,405,2772,1256
1400000US53033029308,190,17,15,138,20,2569,102,112,758,597,326,454,220,2355,674
1400000US53033029309,524,186,56,154,128,2943,64,64,514,787,268,899,347,2815,1246
1400000US53033029403,565,81,189,238,57,4114,184,258,994,1126,411,877,264,3672,1141
1400000US53033029405,488,52,128,272,36,4070,231,113,922,1051,567,841,345,3726,1186
1400000US53033029406,262,27,45,183,7,3332,168,151,685,610,342,987,389,3013,1376
1400000US53033029407,259,26,102,123,8,3132,293,326,670,935,210,555,143,2513,698
1400000US53033029408,340,50,97,173,20,3227,285,301,874,798,384,443,142,2641,585
1400000US53033029504,892,95,268,463,66,3988,271,296,1135,813,489,768,216,3421,984
1400000US53033029505,411,40,0,282,89,2545,195,186,559,607,328,522,148,2164,670
1400000US53033029506,380,69,183,128,0,2864,300,319,1107,527,261,311,39,2245,350
1400000US53033029507,256,0,76,155,25,2321,382,60,649,417,338,288,187,1879,475
1400000US53033029508,506,165,186,101,54,2266,46,182,541,475,336,475,211,2038,686
1400000US53033029602,394,48,117,194,35,4277,106,171,896,979,470,1200,455,4000,1655
1400000US53033029603,503,38,215,205,45,2705,404,260,420,515,188,754,164,2041,918
1400000US53033029604,164,0,36,128,0,2216,166,166,792,464,234,319,75,1884,394
1400000US53033029701,419,28,210,163,18,3334,213,224,936,983,364,495,119,2897,614
1400000US53033029702,125,84,0,41,0,2158,108,153,554,515,331,373,124,1897,497
1400000US53033029803,402,10,64,206,122,2257,109,155,516,606,113,488,270,1993,758
1400000US53033029804,414,88,45,265,16,3077,148,117,681,725,403,566,437,2812,1003
1400000US53033029805,322,197,88,19,18,3102,70,90,1026,850,280,651,135,2942,786
1400000US53033029806,366,14,100,212,40,3886,83,171,710,1068,457,939,458,3632,1397
1400000US53033029901,521,176,173,80,92,3070,90,231,963,804,327,587,68,2749,655
1400000US53033029902,247,36,16,156,39,3462,124,126,979,787,267,922,257,3212,1179
1400000US53033030003,629,125,298,206,0,4648,562,223,1381,767,420,808,487,3863,1295
1400000US53033030005,483,25,216,232,10,3654,298,341,996,1065,236,606,112,3015,718
1400000US53033030006,313,48,187,39,39,3052,296,255,775,830,229,507,160,2501,667
1400000US53033030007,850,25,146,615,64,1389,142,217,241,283,180,191,135,1030,326
1400000US53033030008,557,78,340,120,19,3094,124,276,939,811,238,592,114,2694,706
1400000US53033030101,403,35,51,199,118,2429,0,151,703,772,213,291,299,2278,590
1400000US53033030102,315,15,109,173,18,2929,133,23,506,572,296,833,566,2773,1399
1400000US53033030201,713,40,359,305,9,3818,185,250,1242,931,412,589,209,3383,798
1400000US53033030203,350,23,135,177,15,2383,45,102,927,547,184,494,84,2236,578
1400000US53033030204,131,2,22,49,58,2861,126,357,633,332,515,797,101,2378,898
1400000US53033030304,368,19,142,172,35,2793,132,239,1010,578,219,418,197,2422,615
1400000US53033030305,553,66,181,177,129,3385,61,197,699,785,400,848,395,3127,1243
1400000US53033030306,571,87,252,205,27,3816,97,206,679,982,478,871,503,3513,1374
1400000US53033030308,822,46,389,387,0,3747,99,228,820,996,408,786,410,3420,1196
1400000US53033030309,717,83,326,308,0,3841,41,176,879,786,630,982,347,3624,1329
1400000US53033030310,653,75,221,313,44,4680,255,208,803,1022,547,1306,539,4217,1845
1400000US53033030311,270,31,129,94,16,3316,28,176,969,1088,302,594,159,3112,753
1400000US53033030312,461,28,203,173,57,3495,278,149,1005,802,351,622,288,3068,910
1400000US53033030313,345,69,123,143,10,3237,268,153,1199,615,383,499,120,2816,619
1400000US53033030314,238,18,126,81,13,3594,52,238,1205,751,213,615,520,3304,1135
1400000US53033030403,285,5,171,89,20,3610,59,88,999,805,331,949,379,3463,1328
1400000US53033030404,324,22,79,158,65,3344,47,121,1002,967,433,599,175,3176,774
1400000US53033030405,277,0,170,103,4,2314,79,434,389,563,338,432,79,1801,511
1400000US53033030406,515,216,141,158,0,1893,234,0,451,386,302,349,171,1659,520
1400000US53033030407,119,0,84,0,35,1654,103,150,323,322,219,340,197,1401,537
1400000US53033030501,113,21,25,31,36,1812,69,81,665,486,223,178,110,1662,288
1400000US53033030503,543,102,298,117,26,3141,116,172,821,969,256,517,290,2853,807
1400000US53033030504,223,36,45,142,0,3374,87,315,898,1111,358,418,187,2972,605
1400000US53033030600,270,38,128,67,37,4099,225,387,1535,589,609,574,180,3487,754
1400000US53033030700,503,27,343,111,22,2813,201,262,832,812,362,288,56,2350,344
1400000US53033030801,535,124,225,186,0,3737,753,521,1225,758,193,126,161,2463,287
1400000US53033030802,242,54,98,40,50,2449,228,307,807,439,242,229,197,1914,426
1400000US53033030901,363,44,202,110,7,2545,280,207,800,603,225,384,46,2058,430
1400000US53033030902,439,112,164,132,31,4126,66,562,1164,967,512,468,387,3498,855
1400000US53033031000,230,22,65,88,55,3176,60,86,529,663,291,979,568,3030,1547
1400000US53033031101,260,63,117,74,6,2934,53,199,1033,618,410,540,81,2682,621
1400000US53033031102,193,112,38,39,4,2258,36,90,628,735,289,363,117,2132,480
1400000US53033031202,667,240,150,186,91,4238,110,464,1243,946,329,732,414,3664,1146
1400000US53033031204,292,26,91,111,64,4494,12,212,1052,1232,490,903,593,4270,1496
1400000US53033031206,1000,84,194,699,23,3155,178,180,889,679,348,558,323,2797,881
1400000US53033031207,317,0,237,69,11,2529,42,244,677,678,341,306,241,2243,547
1400000US53033031208,564,101,95,318,50,2725,182,158,802,427,395,612,149,2385,761
1400000US53033031301,120,29,40,51,0,1598,67,71,394,360,311,235,160,1460,395
1400000US53033031302,348,85,107,132,24,2950,74,188,913,836,304,458,177,2688,635
1400000US53033031400,477,88,116,224,49,4433,116,42,1677,975,299,925,399,4275,1324
1400000US53033031501,347,38,150,121,38,2817,59,115,707,611,437,629,259,2643,888
1400000US53033031502,281,39,81,109,52,3638,112,56,930,1162,323,695,360,3470,1055
1400000US53033031601,455,67,203,132,53,3951,91,169,864,1203,435,906,283,3691,1189
1400000US53033031603,560,180,268,112,0,4414,116,97,771,1110,395,953,972,4201,1925
1400000US53033031604,344,79,129,122,14,3328,5,37,635,845,284,1128,394,3286,1522
1400000US53033031605,274,99,78,65,32,3150,0,20,618,563,468,1108,373,3130,1481
1400000US53033031704,664,103,286,185,90,3965,278,254,972,998,390,843,230,3433,1073
1400000US53033031705,316,99,60,146,11,2830,112,231,582,677,268,640,320,2487,960
1400000US53033031707,256,52,23,110,71,1972,14,30,343,375,244,742,224,1928,966
1400000US53033031708,219,21,127,51,20,2951,87,83,860,697,226,579,419,2781,998
1400000US53033031709,249,0,173,76,0,2537,0,129,632,546,463,523,244,2408,767
1400000US53033031710,326,172,73,81,0,3177,31,136,871,952,368,576,243,3010,819
1400000US53033031800,256,31,111,114,0,3665,27,90,799,1028,313,975,433,3548,1408
1400000US53033031904,168,108,27,8,25,2489,16,30,522,597,232,870,222,2443,1092
1400000US53033031906,107,19,25,37,26,2693,18,131,405,537,324,729,549,2544,1278
1400000US53033031908,380,22,210,101,47,2958,19,110,533,834,373,724,365,2829,1089
1400000US53033031909,334,14,11,309,0,2177,81,15,444,425,262,731,219,2081,950
1400000US53033031910,237,1,89,135,12,3085,80,82,532,537,331,1154,369,2923,1523
1400000US53033031911,127,15,0,97,15,2992,71,56,515,671,311,948,420,2865,1368
1400000US53033031912,428,268,160,0,0,3028,144,122,1156,537,241,567,261,2762,828
1400000US53033031913,277,4,159,65,49,2410,0,39,652,473,210,844,192,2371,1036
1400000US53033032002,173,38,66,69,0,2196,0,68,628,453,227,591,229,2128,820
1400000US53033032003,490,48,202,91,149,3842,5,114,772,863,471,1156,461,3723,1617
1400000US53033032005,437,46,121,159,111,5070,147,291,1280,1397,751,994,210,4632,1204
1400000US53033032006,321,16,157,108,40,3799,11,84,1007,1046,456,917,278,3704,1195
1400000US53033032007,166,40,63,48,15,2395,22,126,460,576,278,693,240,2247,933
1400000US53033032008,345,95,84,148,18,3113,8,59,605,870,424,865,282,3046,1147
1400000US53033032010,329,40,66,183,40,4235,23,103,969,835,477,1142,686,4109,1828
1400000US53033032011,147,50,41,37,19,2832,37,177,465,603,290,728,532,2618,1260
1400000US53033032102,267,28,85,138,16,3873,11,82,628,677,280,1426,769,3780,2195
1400000US53033032103,331,60,112,99,60,3864,183,128,479,724,329,1375,646,3553,2021
1400000US53033032104,322,56,172,61,33,4895,266,102,530,962,265,1847,923,4527,2770
1400000US53033032207,198,68,52,27,51,2575,24,35,111,411,72,1125,797,2516,1922
1400000US53033032211,168,24,16,111,17,3192,46,33,158,382,207,1417,949,3113,2366
1400000US53033032213,222,31,19,88,84,3132,20,70,210,658,105,1188,881,3042,2069
1400000US53033032215,359,51,142,93,73,3431,32,12,96,91,184,1593,1423,3387,3016
1400000US53033032216,189,67,47,42,33,3084,12,44,380,256,161,1320,911,3028,2231
1400000US53033032217,107,0,52,33,22,2882,0,20,151,213,168,1545,785,2862,2330
1400000US53033032218,234,61,47,31,95,4532,200,39,420,597,560,1491,1225,4293,2716
1400000US53033032219,327,40,43,197,47,3455,150,17,228,474,198,1572,816,3288,2388
1400000US53033032220,296,21,78,150,47,6510,44,31,584,739,451,2715,1946,6435,4661
1400000US53033032221,179,1,132,46,0,4427,2,76,230,364,371,1842,1542,4349,3384
1400000US53033032222,397,17,8,166,206,2654,0,133,112,448,244,1139,578,2521,1717
1400000US53033032223,199,45,43,71,40,2636,18,39,181,384,38,1139,837,2579,1976
1400000US53033032224,108,0,60,41,7,1572,13,14,68,137,66,432,842,1545,1274
1400000US53033032225,174,9,13,76,76,2211,38,25,81,177,42,968,880,2148,1848
1400000US53033032307,284,51,114,67,52,4375,65,38,811,632,372,1455,1002,4272,2457
1400000US53033032311,386,112,48,163,63,4475,136,90,685,739,301,1433,1091,4249,2524
1400000US53033032313,309,14,104,107,84,4505,0,152,396,526,113,1774,1544,4353,3318
1400000US53033032315,196,27,87,75,7,4042,18,75,540,860,285,1332,932,3949,2264
1400000US53033032316,270,35,90,116,29,3584,0,47,215,274,200,1539,1309,3537,2848
1400000US53033032317,330,50,74,176,30,4419,51,111,128,562,335,1765,1467,4257,3232
1400000US53033032318,419,93,166,110,50,4303,17,57,164,386,245,1705,1729,4229,3434
1400000US53033032319,708,132,134,378,64,4689,53,77,935,973,272,1553,826,4559,2379
1400000US53033032320,281,13,68,137,63,3478,29,85,181,607,271,1290,1015,3364,2305
1400000US53033032321,316,48,131,85,52,4703,43,44,108,414,203,2130,1761,4616,3891
1400000US53033032322,139,25,0,73,41,2251,0,22,95,261,159,1031,683,2229,1714
1400000US53033032323,293,13,58,193,29,4038,42,85,242,549,216,1286,1618,3911,2904
1400000US53033032324,537,28,164,94,251,4384,66,64,368,581,169,1526,1610,4254,3136
1400000US53033032325,434,40,37,89,268,4100,39,41,399,516,305,1576,1224,4020,2800
1400000US53033032326,279,72,33,154,20,2716,145,117,165,420,167,1133,569,2454,1702
1400000US53033032327,198,7,75,86,30,3799,14,97,331,593,274,1300,1190,3688,2490
1400000US53033032328,113,36,14,9,54,2300,8,18,193,274,161,808,838,2274,1646
1400000US53033032330,139,0,10,57,72,3604,0,0,121,282,247,1530,1424,3604,2954
1400000US53033032331,473,0,0,118,355,3590,41,19,284,563,196,1388,1099,3530,2487
1400000US53033032332,299,49,57,120,73,3985,25,0,155,297,166,1969,1373,3960,3342
1400000US53033032333,29,0,22,0,7,2121,0,12,131,176,114,760,928,2109,1688
1400000US53033032401,296,70,104,105,17,4073,25,23,652,654,473,1621,625,4025,2246
1400000US53033032402,375,60,173,127,15,5047,151,67,742,1273,490,1533,791,4829,2324
1400000US53033032500,379,79,86,155,59,4116,65,131,529,872,517,1376,626,3920,2002
1400000US53033032601,255,42,81,67,65,2094,62,161,422,508,110,593,238,1871,831
1400000US53033032603,118,20,53,45,0,2834,13,0,290,468,93,1214,756,2821,1970
1400000US53033032604,246,0,159,66,21,3659,0,11,154,511,295,1676,1012,3648,2688
1400000US53033032605,84,27,41,0,16,2659,0,37,318,248,146,1128,782,2622,1910
1400000US53033032703,146,51,10,52,33,1512,20,56,259,442,172,416,147,1436,563
1400000US53033032704,623,119,277,183,44,5243,215,167,629,1198,478,1593,963,4861,2556
1400000US53033032705,109,80,15,14,0,2606,12,31,551,555,220,718,519,2563,1237
1400000US53033032706,150,20,64,45,21,2134,3,46,501,517,348,640,79,2085,719
1400000US53033032800,190,10,54,116,10,2085,14,66,363,470,216,640,316,2005,956
1400000US53033990100,0,0,0,0,0,0,0,0,0,0,0,0,0,0,0
